{
  "`": ["ذ", "ّ"],
  "1": ["١", "!"],
  "2": ["٢", "@"],
  "3": ["٣", "#"],
  "4": ["٤", "$"],
  "5": ["٥", "%"],
  "6": ["٦", "^"],
  "7": ["٧", "&"],
  "8": ["٨", "*"],
  "9": ["٩", "("],
  "0": ["٠", ")"],
  "-": ["-", "_"],
  "=": ["=", "+"],
  "Q": ["ض", "َ"],
  "W": ["ص", "ً"],
  "E": ["ث", "ُ"],
  "R": ["ق", "ٌ"],
  "T": ["ف", "ﻹ"],
  "Y": ["غ", "إ"],
  "U": ["ع", "‘"],
  "I": ["ه", "÷"],
  "O": ["خ", "×"],
  "P": ["ح", "؛"],
  "[": ["ج", "<"],
  "]": ["د", ">"],
  "\\":["\\", "|"],
  "A": ["ش", "ِ"],
  "S": ["س", "ٍ"],
  "D": ["ي", "]"],
  "F": ["ب", "["],
  "G": ["ل", "ﻷ"],
  "H": ["ا", "أ"],
  "J": ["ت", "ـ"],
  "K": ["ن", "،"],
  "L": ["م", "/"],
  ";": ["ك", ":"],
  "'": ["ط", "\""],
  "Z": ["ئ", "~"],
  "X": ["ء", "ْ"],
  "C": ["ؤ", "}"],
  "V": ["ر", "{"],
  "B": ["لا", "ﻵ"],
  "N": ["ى", "آ"],
  "M": ["ة", "’"],
  ",": ["و", ","],
  ".": ["ز", "."],
  "/": ["ظ", "؟"]
}