{
  "`": ["'", "\""],
  "1": ["1", "!"],
  "2": ["2", "@"],
  "3": ["3", "#"],
  "4": ["4", "$"],
  "5": ["5", "%"],
  "6": ["6", "¨"],
  "7": ["7", "&"],
  "8": ["8", "*"],
  "9": ["9", "("],
  "0": ["0", ")"],
  "-": ["-", "_"],
  "=": ["=", "+"],
  "Q": ["q", "Q"],
  "W": ["w", "W"],
  "E": ["e", "E"],
  "R": ["r", "R"],
  "T": ["t", "T"],
  "Y": ["y", "Y"],
  "U": ["u", "U"],
  "I": ["i", "I"],
  "O": ["o", "O"],
  "P": ["p", "P"],
  "[": ["´", "`"],
  "]": ["[", "{"],
  "\\":["\\", "|"],
  "A": ["a", "A"],
  "S": ["s", "S"],
  "D": ["d", "D"],
  "F": ["f", "F"],
  "G": ["g", "G"],
  "H": ["h", "H"],
  "J": ["j", "J"],
  "K": ["k", "K"],
  "L": ["l", "L"],
  ";": ["ç", "Ç"],
  "'": ["~", "^"],
  "Z": ["z", "Z"],
  "X": ["x", "X"],
  "C": ["c", "C"],
  "V": ["v", "V"],
  "B": ["b", "B"],
  "N": ["n", "N"],
  "M": ["m", "M"],
  ",": [",", "<"],
  ".": [".", ">"],
  "/": [";", ":"]
}