{
  "`": ["²", "`"],
  "1": ["&", "1"],
  "2": ["é", "2"],
  "3": ["\"", "3"],
  "4": ["'", "4"],
  "5": ["(", "5"],
  "6": ["-", "6"],
  "7": ["è", "7"],
  "8": ["_", "8"],
  "9": ["ç", "9"],
  "0": ["à", "0"],
  "-": [")", "°"],
  "=": ["=", "+"],
  "Q": ["a", "A"],
  "W": ["z", "Z"],
  "E": ["e", "E"],
  "R": ["r", "R"],
  "T": ["t", "T"],
  "Y": ["y", "Y"],
  "U": ["u", "U"],
  "I": ["i", "I"],
  "O": ["o", "O"],
  "P": ["p", "P"],
  "[": ["^", "¨"],
  "]": ["$", "£"],
  "\\":["*", "µ"],
  "A": ["q", "Q"],
  "S": ["s", "S"],
  "D": ["d", "D"],
  "F": ["f", "F"],
  "G": ["g", "G"],
  "H": ["h", "H"],
  "J": ["j", "J"],
  "K": ["k", "K"],
  "L": ["l", "L"],
  ";": ["m", "M"],
  "'": ["ù", "%"],
  "Z": ["w", "W"],
  "X": ["x", "X"],
  "C": ["c", "C"],
  "V": ["v", "V"],
  "B": ["b", "B"],
  "N": ["n", "N"],
  "M": [",", "?"],
  ",": [";", "."],
  ".": [":", "/"],
  "/": ["!", "§"]
}
