{
  "`": [";", ":"],
  "1": ["1", "!"],
  "2": ["2", "\""],
  "3": ["3", "#"],
  "4": ["4", "$"],
  "5": ["5", "%"],
  "6": ["6", "&"],
  "7": ["7", "/"],
  "8": ["8", "("],
  "9": ["9", ")"],
  "0": ["0", "="],
  "-": ["-", "_"],
  "=": ["=", "+"],
  "Q": ["ς", ":"],
  "W": ["w", "W"],
  "E": ["ε", "Ε"],
  "R": ["ρ", "Ρ"],
  "T": ["τ", "Τ"],
  "Y": ["υ", "Υ"],
  "U": ["θ", "Θ"],
  "I": ["ι", "Ι"],
  "O": ["ο", "Ο"],
  "P": ["π", "Π"],
  "[": ["[", "{"],
  "]": ["]", "}"],
  "\\":["\\","|"],
  "A": ["α", "Α"],
  "S": ["σ", "Σ"],
  "D": ["δ", "Δ"],
  "F": ["φ", "Φ"],
  "G": ["γ", "Γ"],
  "H": ["η", "Η"],
  "J": ["ξ", "Ξ"],
  "K": ["κ", "Κ"],
  "L": ["λ", "Λ"],
  ";": ["΄", "¨"],
  "'": ["'", "\""],
  "Z": ["ζ", "Ζ"],
  "X": ["χ", "Χ"],
  "C": ["ψ", "Ψ"],
  "V": ["ω", "Ω"],
  "B": ["β", "Β"],
  "N": ["ν", "Ν"],
  "M": ["μ", "Μ"],
  ",": [",", "<"],
  ".": [".", ">"],
  "/": ["/", "?"]
}
