{
  "`": ["`", "~"],
  "1": ["१", "!"],
  "2": ["२", "@"],
  "3": ["३", "#"],
  "4": ["४", "$"],
  "5": ["५", "%"],
  "6": ["६", "^"],
  "7": ["७", "&"],
  "8": ["८", "*"],
  "9": ["९", "("],
  "0": ["०", ")"],
  "-": ["-", "_"],
  "=": ["ृ", "ऋ"],
  "Q": ["ौ", "औ"],
  "W": ["ै", "ऐ"],
  "E": ["ा", "आ"],
  "R": ["ी", "ई"],
  "T": ["ू", "ऊ"],
  "Y": ["ब", "भ"],
  "U": ["ह", "ङ"],
  "I": ["ग", "घ"],
  "O": ["द", "ध"],
  "P": ["ज", "झ"],
  "[": ["ड", "ढ"],
  "]": ["़", "ञ"],
  "\\":["ॄ", "ॠ"],
  "A": ["ो", "ओ"],
  "S": ["े", "ए"],
  "D": ["्", "अ"],
  "F": ["ि", "इ"],
  "G": ["ु", "उ"],
  "H": ["प", "फ"],
  "J": ["र", "ऱ"],
  "K": ["क", "ख"],
  "L": ["त", "थ"],
  ";": ["च", "छ"],
  "'": ["ट", "ठ"],
  "Z": ["ँ", "ं"],
  "X": ["म", "ण"],
  "C": ["न", null],
  "V": ["व", null],
  "B": ["ल", "ळ"],
  "N": ["स", "ष"],
  "M": [",", "श"],
  ",": [".", "य़"],
  ".": ["य", null],
  "/": ["/", "?"]
}