{
  "`": ["`", "~"],
  "1": ["1", "!"],
  "2": ["2", "@"],
  "3": ["3", "#"],
  "4": ["4", "$"],
  "5": ["5", "%"],
  "6": ["6", "^"],
  "7": ["7", "&"],
  "8": ["8", "*"],
  "9": ["9", "("],
  "0": ["0", ")"],
  "-": ["-", "_"],
  "=": ["=", "+"],
  "Q": ["ض", "َ"],
  "W": ["ص", "ً"],
  "E": ["ث", "ُ"],
  "R": ["ق", "ٌ"],
  "T": ["ف", "،"],
  "Y": ["غ", "آ"],
  "U": ["ع", "‘"],
  "I": ["ه", "]"],
  "O": ["خ", "["],
  "P": ["ح", "{"],
  "[": ["ج", "}"],
  "]": ["چ", "؛"],
  "\\":["\\", "|"],
  "A": ["ش", "ِ"],
  "S": ["س", "ٍ"],
  "D": ["ی", "‌"],
  "F": ["ب", "لإ"],
  "G": ["ل", "لأ"],
  "H": ["ا", "أ"],
  "J": ["ت", "ـ"],
  "K": ["ن", "»"],
  "L": ["م", "«"],
  ";": ["ک", ":"],
  "'": ["گ", "\""],
  "Z": ["ظ", "ّ"],
  "X": ["ط", "ْ"],
  "C": ["ز", "ژ"],
  "V": ["ر", "ؤ"],
  "B": ["ذ", "إ"],
  "N": ["د", "أ"],
  "M": ["پ", "ء"],
  ",": ["و", ">"],
  ".": [".", "<"],
  "/": ["/", "؟"]
}
