{
  "`": ["|", "§"],
  "1": ["1", "!"],
  "2": ["2", "\""],
  "3": ["3", "#"],
  "4": ["4", "¤"],
  "5": ["5", "%"],
  "6": ["6", "&"],
  "7": ["7", "/"],
  "8": ["8", "("],
  "9": ["9", ")"],
  "0": ["0", "="],
  "-": ["+", "?"],
  "=": ["\\", "`"],
  "[": ["å", "Å"],
  "]": ["¨", "^"],
  "\\":["'", "*"],
  ";": ["ø", "Ø"],
  "'": ["æ", "Æ"],
  ",": [",", ";"],
  ".": [".", ":"],
  "/": ["-", "_"],
  "Z": ["z", "Z"],
  "X": ["x", "X"],
  "C": ["c", "C"],
  "V": ["v", "V"],
  "B": ["b", "B"],
  "N": ["n", "N"],
  "M": ["m", "M"]
}
