{
  "`": ["`", "~"],
  "1": ["1", "!"],
  "2": ["2", "@"],
  "3": ["3", "#"],
  "4": ["4", "$"],
  "5": ["5", "%"],
  "6": ["6", "^"],
  "7": ["7", "&"],
  "8": ["8", "*"],
  "9": ["9", "("],
  "0": ["0", ")"],
  "-": ["-", "۔"],
  "=": ["=", "+"],
  "Q": ["ق", "ْ"],
  "W": ["و", "ّ"],
  "E": ["ع", ":"],
  "R": ["ر", ""],
  "T": ["ت", "ٹ"],
  "Y": ["ے", "َ"],
  "U": ["ئ", "ُ"],
  "I": ["ی", "ِ"],
  "O": ["ہ", "ۃ"],
  "P": ["پ", "،"],
  "[": ["[", "{"],
  "]": ["]", "}"],
  "\\":["\\", "|"],
  "A": ["ا", "آ"],
  "S": ["س", "ص"],
  "D": ["د", "ڈ"],
  "F": ["ف", ""],
  "G": ["گ", "غ"],
  "H": ["ھ", "ح"],
  "J": ["ج", "ض"],
  "K": ["ک", "خ"],
  "L": ["ل", ""],
  ";": [";", ":"],
  "'": ["'", "\""],
  "Z": ["ز", "ذ"],
  "X": ["ش", "ژ"],
  "C": ["چ", "ث"],
  "V": ["ط", "ظ"],
  "B": ["ب", ""],
  "N": ["ن", "ں"],
  "M": ["م", ""],
  ",": [",", "<"],
  ".": [".", ">"],
  "/": ["/", "؟"]
}
