{
  "`": ["ё", "Ё"],
  "1": ["1", "!"],
  "2": ["2", "\""],
  "3": ["3", "№"],
  "4": ["4", ";"],
  "5": ["5", "%"],
  "6": ["6", ":"],
  "7": ["7", "?"],
  "8": ["8", "*"],
  "9": ["9", "("],
  "0": ["0", ")"],
  "-": ["-", "_"],
  "=": ["=", "+"],
  "Q": ["й", "Й"],
  "W": ["ц", "Ц"],
  "E": ["у", "У"],
  "R": ["к", "К"],
  "T": ["е", "Е"],
  "Y": ["н", "Н"],
  "U": ["г", "Г"],
  "I": ["ш", "Ш"],
  "O": ["щ", "Щ"],
  "P": ["з", "З"],
  "[": ["х", "Х"],
  "]": ["ъ", "Ъ"],
  "\\":["\\", "/"],
  "A": ["ф", "Ф"],
  "S": ["ы", "Ы"],
  "D": ["в", "В"],
  "F": ["а", "А"],
  "G": ["п", "П"],
  "H": ["р", "Р"],
  "J": ["о", "О"],
  "K": ["л", "Л"],
  "L": ["д", "Д"],
  ";": ["ж", "Ж"],
  "'": ["э", "Э"],
  "Z": ["я", "Я"],
  "X": ["ч", "Ч"],
  "C": ["с", "С"],
  "V": ["м", "М"],
  "B": ["и", "И"],
  "N": ["т", "Т"],
  "M": ["ь", "Ь"],
  ",": ["б", "Б"],
  ".": ["ю", "Ю"],
  "/": [".", ","]
}